##########           ###########
#                              #
#      R                       #
#                      #    R  #
#                      #       #
#            #         #       #
#    R       #         #       *
#            #         #       #
#            #                 #
#     ########                 #
#                              #
#                              #
#                              #
































































































































































































































##########                                                                                      ##########