##################################           ###########################################
#                                                                                      #
#      R                                                                               #
#                      #    R                                                          #
#                      #                                                               #
#            #         #                                                               #
#    R       #         #                                                               #
#            #         #                                                               #
#            #                                                                         #
#     ########                                                                         #
#                                                                                      #
#                                                                                      #
#               S                                                                      #
#                                                                                      #
#                                                                                      #
#                                                                                      #
#                                                                                      #
#                                                                                      #
#                                                                                      #
##################################            ##########################################